00000000000000000000
00000000000000000000
00000000000000000000
00000000000000000000
00000000000000000000
00000000000000000000
00000000000000000000
00000000022222222222
00000000011111111111
22       11111111111
11       11111111111
11222222211111111111
11111111111111111111
11111111111111111111