00000000000000000000
00000000000000000000
00000000000000000000
00000000000000000000
00000000000000000000
00000000000000000000
00000000000000000000
00000000000000000000
00000000000000000000
22222222222222222222
11111111111111111111
11111111111111111111
11111111111111111111
11111111111111111111