00000000000000000000
00000000000000000000
00000000000000000000
00000000000000000000
00000000000000000000
00000000000000000000
00000000022222222222
00000000011111111111
00000000011111111111
22       11111111111
112      11111111111
11122222211111111111
11111111111111111111
11111111111111111111