00000000000000000000
00000000000000000000
00000000000000000000
00000000000000000000
00000000000000000000
00000000000000000000
00000001111111100000
00000000000000000000
00000000000000000000
00000000000000000000
11111111111111111111
11111111111111111111
11111111111111111111
11111111111111111111
